1111111111111111
4001000000000001
1001001111111001
1001000001000001
1001111001001111
1001000001001001
1001001111001001
1000001000001001
1001111001111001
1000001000000003
1111111111111111