1111111111111111
4000001000000001
1111001001111001
1000001000001001
1001111111001001
1000000000001001
1111111111111001
1001000001000001
1001001001001111
1000001000000003
1111111111111111
