1111111111111111
4000000000001001
1001111111001001
1001000001000001
1001001001001111
1001001001000001
1001111001111001
1000000001000001
1111001001001111
1000001001000003
1111111111111111