1111111111111111
4001000001000001
1001111001001001
1000000001001001
1001111111001001
1000001000001001
1111001001111001
1000001000001001
1001111111111001
1000000000000003
1111111111111111