1111111111111111
4000001000001001
1111001001001001
1000001001001001
1001111001001001
1000000001001001
1111111111001001
1000001001000001
1001001001111001
1001000000000003
1111111111111111