1111111111111111
4000001000000001
1111001001001111
1001001001000001
1001001111111001
1001000001000001
1001111001001111
1000000001000001
1111001111111001
1000000000000003
1111111111111111