1111111111111111
4000000001000001
1001111111001001
1000001000001001
1111001001111001
1000001001000001
1001001001001111
1001001001001001
1001001001001001
1001000001000003
1111111111111111